5 6

1 0 0 0 0 1
1 1 0 0 1 1 
1 0 1 1 0 1
1 0 0 0 0 1
1 0 1 1 0 1
1 0 0 0 0 1

1 1 0 0 0 0 1 
1 0 0 1 1 0 1
1 0 0 0 0 0 1
1 0 0 1 1 0 1
1 1 0 0 0 0 1

2 3

4 3

0 3

11