5 5 

1 1 0 0 1 1
1 0 0 0 0 1
1 0 1 0 1 1
1 0 0 1 1 1
1 0 0 0 0 1

1 0 0 0 0 1
1 1 1 1 1 1
1 0 0 0 0 1
1 1 0 0 1 1
1 0 0 0 0 1

3 2

2 3

3 0

7